R 1000 800
S ./textures/sprites/lata.xpm
NO ./textures/walls/caixa01.xpm
WE ./textures/walls/caixa02.xpm
EA ./textures/walls/caixa03.xpm
SO ./textures/walls/caixa04.xpm

C 127,255,212
F 128,128,0

111111111111111          11111111
100000000000001          1000S001
100000000000001111111111110000001
102011111110200000000000000000001
100000000000001111111111110000001
111110000000001          10000201
    101002000011111      10000001
    10101110000000111111110000001
    10100020000000000000000000001
    10100011111000111111111111111
    121000000000021
    100000000111111
11111001111111
10000000000001
10000000000001111111111111111
10002000000000000000000002001
10000000000000002000000000001
10000000000111111110000001111
102000002000111   10000021 
110000000000011   10000001
100000020000001111100000011111111
100000000000000000000002000000001
100000200020000000000000000000001
102000000000000020000000000002001
111111111111111111111111111111111