R 1000 800
S ./textures/sprites/lata.xpm
NO ./textures/walls/caixa01.xpm
WE ./textures/walls/caixa02.xpm
EA ./textures/walls/caixa03.xpm
SO ./textures/walls/caixa04.xpm

C 10,154,217
F 112,191,223

111111111111111          11111111
100000000000001          10000001
100000000000001111111111110000001
102011111110200000000000000000001
100000000000001111111111110000001
111110000000001          10000001
    101002000011111      11111111
    101011100000001
    101000200000001
    101000111110001
    121000000000021
    100000000111111
111110011111111
100000011111111
100000001111111
100020000111111
100000000011111
100000000001111
102000002000111
110000000000011
111000020W00001
111100000000001
111110200020001
111111000000001
111111111111111