R 1920 1080
S ./textures/sprites/cacto.xpm
NO ./textures/walls/muro01.xpm
WE ./textures/walls/muro02.xpm
EA ./textures/walls/muro03.xpm
SO ./textures/walls/muro04.xpm
C 255,99,71
F 128,128,0

1111111111111111111111111111
1000000020000000002000000001
1020000000002000000000000001
100000S000000000002000000001
1020000000002000000000000001
1000000000000000002000002001
1020000200002000000002000001
1000000000000000002000000001
1020000200002000000000000001
1111111111111111111111111111