R 1920 1080
S ./textures/sprites/cacto.xpm
NO ./textures/walls/muro01.xpm
WE ./textures/walls/muro02.xpm
EA ./textures/walls/muro03.xpm
SO ./textures/walls/muro04.xpm
C 255,99,71
F 128,128,0

1111111111111111111111111111
1000000020000000002000000001
1020000000002000000000000001
100000S000000000002000000001
1020000000002000000000000001
1000000000000000002000002001
1020000200002000000002000001
1000000000000000002000000001
1020000200002000000000000001
1110000001111000000000000001
  10000001  1000000000000001
  10000001111000001000000001
  10000000000000001000000001
  1000000111100000100000000111111111
  11111111  100000100000000000000001
            100000100000000100000001
111111111111100011111110000100000001
100000000000000000000000000111111001
100000010002000000200000000000001001
100000010000100000000000000000001001
100000010000111100111100000000001001
1000111111111  1001  100000000000001
10001          1001  111111011111111
10001          1001       101
10001111111111110011111111101111111
10001000000000000000000000000000001
10000020000000002000000002000000001
11111111111111111111111111111111111